******************************************************************************************************************************************************
******************************************************************************************************************************************************
**                            **                                                          **                            **                          **
**                            **                                                          **                            **                          **
**                            **                                                          **                            **                          **
**                            **                                                          **                            **          ffffffffffff    **
**                            **                                                          **                            **          ffffffffffff    **
**                            **                                                          **                            **          ffffffffffff    **
**                            **                                                          **                            **          ffffffffffff    **
**        dddddddddddd        **                                                          **                            **          ffffffffffff    **
**        dddddddddddd        **                                                          **                            **          ffffffffffff    **
**        dddddddddddd        **                                                          **                            **          ffffffffffff    **
**        dddddddddddd        **                                                          **                            **          ffffffffffff    **
**        dddddddddddd        **                                                          **                            **                          **
**        dddddddddddd        **                                                          **                            **                          **
**        dddddddddddd        **                                                          **                            **                          **
**        dddddddddddd        **                                                          **                            **                          **
**                            **                                                          **                            **                          **
**                            **                                                          **                            **                          **
**                            **                                                          **                            **                          **
**                            **                                                          **                            **                          **
**                            **                                                          **                            **                          **
**                            **                                                          **                            **                          **
**                            **                                                          **                            **                          **
**                            **                                                          **                            **                          **
**                            **                                                          **                            **                          **
**                            **                                                          **                            **                          **
**                            **                                                          **                            **                          **
**                            **                                                          **                            **                          **
**                            **                                                          **                            **                          **
**                            **                            **                            **                            **                          **
**                            **                            **                            **                            **                          **
**                            **                            **                            **                            **                          **
**                            **                            **                            **                            **                          **
**                            **                            **                            **                            **                          **
**                            **                            **                            **                            **                          **
**                            **                            **                            **                            **                          **
**                            **                            **                            **                            **                          **
**                            **                            **                            **                            **                          **
**                            **                            **                            **                            **                          **
**                            **                            **                            **                            **                          **
**                            **                            **                            **                            **                          **
**                            **                            **                            **                            **                          **
**                            **                            **                            **                            **                          **
**                            **                            **                            **                            **                          **
**                            **                            **                            **                            **                          **
**                            **                            **                            **                            **                          **
**                            **                            **                            **                            **                          **
**                            **                            **                                                          **                          **
**                            **                            **                                                          **                          **
**                            **                            **                                                          **                          **
**                            **                            **                                                          **                          **
**                            **                            **                                                          **                          **
**                            **                            **                                                          **                          **
**                            **                            **                                                          **                          **
**                            **                            **                                                          **                          **
**                            **                            **                                                          **                          **
**                            **                            **                                                          **                          **
**                            **                            **                                                          **                          **
**                            **                            **                                                          **                          **
**                            **                            **                                                          **                          **
**                            **                            **                                                          **                          **
**                            **                            **                                                          **                          **
**                            **                            **                                                          **                          **
**                            **                            **                                                          **                          **
**                            **                            **                                                          **                          **
**                            **                            **                                                          **                          **
**                            **                            **                                                          **                          **
**                            **                            **                                                          **                          **
**                            **                            **                                                          **                          **
**                            **                            **                                                          **                          **
**                            **                            **                                                          **                          **
**                            **                            **                                                          **                          **
**                            **                            **                                                          **                          **
**                            **                            **                                                          **                          **
**                            **                            **                                                          **                          **
**                            **                            **                                                          **                          **
**                            **                            **                                                          **                          **
**                            **                            **                                                          **                          **
**                            **                            **                                                          **                          **
**                            **                            **                                                          **                          **
**                            **                            **                                                          **                          **
**                            **                            **                             **                           **                          **
**                            **                            **                             **                           **                          **
**                            **                            **                             **                           **                          **
**                            **                            **                             **                           **                          **
**                            **                            **                             **                           **                          **
**                            **                            **                             **                           **                          **
**                            **                            **                             **                           **                          **
**                            **                            **                             **                           **                          **
**                            **                            **                             **                           **                          **
**                            **                            **                             **                           **                          **
**                            **                            **                             **                           **                          **
**                            **                            **                             **                           **                          **
**                            **                            **                             **                           **                          **
**                            **                            **                             **                           **                          **
**                            **                            **                             **                           **                          **
**                            **                            **                             **                           **                          **
**                            **                            **                             **                           **                          **
**                            **                            **                             **                           **                          **
**                            **                            **                             **                           **                          **
**                            **                            **                             **                           **                          **
**                            **                            **                             **                                                       **
**                            **                            **                             **                                                       **
**                            **                            **                             **                                                       **
**                            **                            **                             **                                                       **
**                            **                            **                             **                                                       **
**                            **                            **                             **                                                       **
**                            **                            **                             **                                                       **
**                            **                            **                             **                                                       **
**                            **                            **                             **                                                       **
**                            **                            **                             **                                                       **
**                            **                            **                             **                                                       **
**                            **                            **                             **                                                       **
**                            **                            **                             **                                                       **
**                            **                            **                             **                                                       **
**                            **                            **                             **                                                       **
**                            **                            **                             **                                                       **
**                            **                            **                             **                                                       **
**                            **                            **                             **                                                       **
**                                                          **                                                                                      **
**                                                          **                                                                                      **
**                                                          **                                                                                      **
**                                                          **                                                                                      **
**                                                          **                                                                                      **
**                                                          **                                                                                      **
**                                                          **                                                                                      **
**                                                          **                                                                                      **
**                                                          **                                                                                      **
**                                                          **                                                                                      **
**                                                          **                                                                                      **
**                                                          **                                                                                      **
**                                                          **                                                                                      **
**                                                          **                                                                                      **
**                                                          **                                                                                      **
**                                                          **                                                                                      **
**                                                          **                                                                                      **
**                                                          **                                                                                      **
**                                                          **                                                                                      **
**                                                          **                                                                                      **
**                                                          **                                                                                      **
**                                                          **                                                                                      **
**                                                          **                                                                                      **
**                                                          **                                                                                      **
**                                                          **                                                                                      **
**                                                          **                                                                                      **
**                                                          **                                                                                      **
**                                                          **                                                                                      **
******************************************************************************************************************************************************
******************************************************************************************************************************************************