************************
*dddd*            *ffff*
*    *            *    *
*    *            *    *
*    *            *    *
*    *            *    *
*    *            *    *
*    *     *      *    *
*    *     *      *    *
*    *     *      *    *
*    *     *      *    *
*    *     *      *    *
*    *     *      *    *
*    *     *      *    *
*    *     *      *    *
*    *     *           *
*    *     *           *
*    *     *           *
*    *     *           *
*    *     *      *    *
*    *     *      *    *
*    *     *      *    *
*          *      *    *
*          *           *
************************