******************************************************************************************************************************************************
******************************************************************************************************************************************************
**                                                                                                                                                  **
**                                                                                                                                                  **
**                                                                                                                                                  **
**                                                                                                                                                  **
**                                                                                                                                                  **
**                                                                                                                                                  **
**                                                                                                                                                  **
**                                                                                                                                                  **
**                                                                                                                                                  **
**                                                                                                                                                  **
**                                                                                                                                                  **
**                                                                                                                                                  **
**                                                                                                                                                  **
**                                                                                                                                                  **
**                                                                                                                                                  **
**                                                                                                                                                  **
**                                                                                                                                                  **
**                                                                                                                                                  **
**                                                                                                                                                  **
**                                                                                                                                                  **
**                                                                                                                                                  **
**                                                                                                                                                  **
**                                                                                                                                                  **
**                                                                                                                                                  **
**                                                                                                                                                  **
**                                                                                                                                                  **
**                                                                                                                                                  **
**                                                                                                                                                  **
**                                                                                                                                                  **
**                                                                                                                                                  **
**                                                                                                                                                  **
**                                                                                                                                                  **
**                                                                                                                                                  **
**                                                                                                                                                  **
**                                                                                                                                                  **
**                                                                                                                                                  **
**                                                                     ****                                                                         **
**                                                                     ****                                                                         **
**                                                                     ****                                                                         **
**                                                                     ****                                                                         **
**                                                                     ****                                                                         **
**                                                                     ****                                                                         **
**                                                                     ****                                                                         **
**                                                                     ****                                                                         **
**                                                                     ****                                                                         **
**                                                                     ****                                                                         **
**                                                                     ****                                                                         **
**                                                                     ****                                                                         **
**                                                                     ****                                                                         **
**                                                                     ****                                                                         **
**                                                                     ****                                                                         **
**                                                     dddddddddddd    ****                                                                         **
**                                                     dddddddddddd    ****                                                                         **
**                                                     dddddddddddd    ****                                                                         **
**                                                     dddddddddddd    ****                                                                         **
**                                                     dddddddddddd    ****                                                                         **
**                                                     dddddddddddd    ****                                                                         **
**                                                     dddddddddddd    ****                                                                         **
**                                                     dddddddddddd    ****                                                                         **
**                                                                     ****                                                                         **
**                                                                     ****                                                                         **
**                                                                     ****                                                                         **
**                                                                     ****                                                                         **
**                                                                     ****                                                                         **
**                                                                     ****                                                                         **
**                                                                     ****                                                                         **
**                                                 ********************************************                                                     **
**                                                 ********************************************                                                     **
**                                                 ********************************************                                                     **
**                                                 ********************************************                                                     **
**                                                                     ****                                                                         **
**                                                                     ****                                                                         **
**                                                                     ****  ffffffffffff                                                           **
**                                                                     ****  ffffffffffff                                                           **
**                                                                     ****  ffffffffffff                                                           **
**                                                                     ****  ffffffffffff                                                           **
**                                                                     ****  ffffffffffff                                                           **
**                                                                     ****  ffffffffffff                                                           **
**                                                                     ****  ffffffffffff                                                           **
**                                                                     ****  ffffffffffff                                                           **
**                                                                     ****                                                                         **
**                                                                     ****                                                                         **
**                                                                     ****                                                                         **
**                                                                     ****                                                                         **
**                                                                     ****                                                                         **
**                                                                     ****                                                                         **
**                                                                     ****                                                                         **
**                                                                     ****                                                                         **
**                                                                     ****                                                                         **
**                                                                     ****                                                                         **
**                                                                     ****                                                                         **
**                                                                     ****                                                                         **
**                                                                     ****                                                                         **
**                                                                     ****                                                                         **
**                                                                     ****                                                                         **
**                                                                     ****                                                                         **
**                                                                     ****                                                                         **
**                                                                     ****                                                                         **
**                                                                     ****                                                                         **
**                                                                     ****                                                                         **
**                                                                     ****                                                                         **
**                                                                     ****                                                                         **
**                                                                     ****                                                                         **
**                                                                     ****                                                                         **
**                                                                     ****                                                                         **
**                                                                     ****                                                                         **
**                                                                     ****                                                                         **
**                                                                     ****                                                                         **
**                                                                     ****                                                                         **
**                                                                     ****                                                                         **
**                                                                                                                                                  **
**                                                                                                                                                  **
**                                                                                                                                                  **
**                                                                                                                                                  **
**                                                                                                                                                  **
**                                                                                                                                                  **
**                                                                                                                                                  **
**                                                                                                                                                  **
**                                                                                                                                                  **
**                                                                                                                                                  **
**                                                                                                                                                  **
**                                                                                                                                                  **
**                                                                                                                                                  **
**                                                                                                                                                  **
**                                                                                                                                                  **
**                                                                                                                                                  **
**                                                                                                                                                  **
**                                                                                                                                                  **
**                                                                                                                                                  **
**                                                                                                                                                  **
**                                                                                                                                                  **
**                                                                                                                                                  **
**                                                                                                                                                  **
**                                                                                                                                                  **
**                                                                                                                                                  **
**                                                                                                                                                  **
**                                                                                                                                                  **
**                                                                                                                                                  **
**                                                                                                                                                  **
**                                                                                                                                                  **
**                                                                                                                                                  **
**                                                                                                                                                  **
**                                                                                                                                                  **
**                                                                                                                                                  **
**                                                                                                                                                  **
**                                                                                                                                                  **
******************************************************************************************************************************************************
******************************************************************************************************************************************************